##  ################################################################################################
##  ################################################################################################
##  ################################################################################################
##  ################################################################################################
##  ################################################################################################
##    x                                                                             ################
##  ####################################### ##################################### ##################
##  ####################################### ##################################### ##################
##  ####################################### ##################################### ##################
##  ####################################### ##################################### ##################
##  ####################################### ##################################### ##################
##  ####################################### ##################################### ##################
##  ####################################### ##################################### ##################
##  ####################################### ##################################### ##################
##  #######################################*##################################### ##################
##  ####################################### ##################################### ##################
##  ####################################### ##################################### ##################
##  ####################################### ##################################### ##################
##             ############################ ##################################### ##################
######### ################################# ##################################### ##################
######### ################################# ##################################### ##################
######### ################################# ##################################### ##################
######### ################################# ##################################### ##################
#########                                                            ############ ##################
######### ##########################################################################################
######### ##########################################################################################
######### ##########################################################################################
####################################################################################################
####################################################################################################
####################################################################################################
